1 1 X X 1 1 1 1 1 1 1 X X 1 1
2 2 X X 2 2 2 2 2 2 2 X X 2 2
3 3 X X 3 3 3 3 3 3 3 X X 3 3
1 1 X X X X 1 1 1 X X X X 1 1
3 3 X X 3 3 3 3 3 3 3 X X 3 3
2 2 X X 2 2 2 2 2 2 2 X X 2 2
1 1 X X 1 1 X X X 1 1 X X 1 1
