1 1 X 1 1 X X 1 X X 1 1 X 1 1
1 1 X 1 2 2 2 2 2 2 2 1 X 1 1
1 X X 1 3 3 3 3 3 3 3 1 X X 1
1 1 X X X X 2 2 2 X X X X 1 1
1 X X 1 3 3 3 3 3 3 3 1 X X 1
1 1 X 1 2 2 2 2 2 2 2 1 X 1 1
1 1 X X 3 3 X X X 3 3 X X 1 1
